#  # ##
## # ##
  ## ##
# ## ##
# ## ##
#    ##
#######